1121312311
1        1
2   111  1
3   2    3
1        1
1   121111
1        3
1111211  2
3        1
1211323111