1121312311
1        1
2   111  1
3   2    1
1   1  1 1
121 1  1 2
1      2 1
2111   1 1
3        1
1211323111